{
  "rows":11,
  "columns": 13,

  "paddingX": 40,
  "paddingY": 40,
  "cellWidth": 50,
  "cellHeight": 50,

  "startPosX": 0,
  "startPosY": 10,
  "startDirection": 0,

  "horizontalWalls": [[1, 1, 1, 1, 1, 1, 1, 1, 1, 1, 1, 1, 1],
                      [0, 0, 1, 0, 0, 0, 1, 0, 0, 0, 1, 0, 0],
                      [0, 1, 0, 1, 0, 1, 0, 1, 0, 1, 0, 1, 0],
                      [1, 0, 0, 0, 0, 0, 0, 0, 0, 0, 0, 0, 1],
                      [0, 0, 0, 0, 1, 0, 0, 0, 0, 0, 0, 0, 0],
                      [0, 0, 0, 0, 0, 0, 0, 0, 0, 0, 0, 0, 0],
                      [0, 0, 0, 0, 0, 0, 0, 0, 1, 0, 0, 0, 0],
                      [0, 0, 0, 0, 0, 0, 0, 0, 0, 0, 0, 0, 0],
                      [0, 0, 0, 0, 0, 0, 0, 0, 0, 0, 0, 0, 0],
                      [0, 0, 0, 0, 0, 0, 0, 0, 0, 0, 0, 0, 0],
                      [0, 0, 0, 0, 0, 0, 0, 0, 0, 0, 0, 0, 0],
                      [1, 1, 1, 1, 1, 1, 1, 1, 1, 1, 1, 1, 1]
  ],

  "verticalWalls": [[1, 0, 0, 0, 0, 0, 0, 0, 0, 0, 0, 0, 0, 1],
                    [1, 0, 1, 1, 0, 0, 1, 1, 0, 0, 1, 1, 0, 1],
                    [1, 1, 0, 0, 1, 1, 0, 0, 1, 1, 0, 0, 1, 1],
                    [1, 0, 0, 0, 1, 1, 0, 0, 1, 1, 0, 0, 0, 1],
                    [1, 0, 0, 0, 0, 0, 0, 0, 1, 1, 0, 0, 0, 1],
                    [1, 0, 0, 0, 0, 0, 0, 0, 1, 1, 0, 0, 0, 1],
                    [1, 0, 0, 0, 0, 0, 0, 0, 0, 0, 0, 0, 0, 1],
                    [1, 0, 0, 0, 0, 0, 0, 0, 0, 0, 0, 0, 0, 1],
                    [1, 0, 0, 0, 0, 0, 0, 0, 0, 0, 0, 0, 0, 1],
                    [1, 0, 0, 0, 0, 0, 0, 0, 0, 0, 0, 0, 0, 1],
                    [1, 0, 0, 0, 0, 0, 0, 0, 0, 0, 0, 0, 0, 1]

  ],
  
  "beepers": [[0, 0, 0, 0, 0, 0, 0, 0, 0, 0, 0, 0, 0],
              [0, 0, 0, 0, 0, 0, 0, 0, 0, 0, 0, 0, 0],
              [0, 0, 0, 0, 0, 0, 0, 0, 0, 0, 0, 0, 0],
              [1, 0, 0, 0, 0, 0, 0, 0, 0, 0, 0, 0, 1],
              [1, 0, 0, 0, 1, 0, 0, 0, 0, 0, 0, 0, 0],
              [1, 0, 0, 0, 1, 0, 0, 0, 0, 0, 0, 0, 0],
              [1, 0, 0, 0, 1, 0, 0, 0, 0, 0, 0, 0, 0],
              [0, 0, 0, 0, 0, 0, 0, 0, 1, 0, 0, 0, 1],
              [0, 0, 0, 0, 0, 0, 0, 0, 1, 0, 0, 0, 1],
              [0, 0, 0, 0, 1, 0, 0, 0, 0, 0, 0, 0, 0],
              [0, 0, 0, 0, 1, 0, 0, 0, 0, 0, 0, 0, 1]
  ]
}
